{
  "_": 0,
  " ": 1,
  "#": 2,
  "!": 3,
  "\"": 4,
  "(": 5,
  ")": 6,
  "-": 7,
  ".": 8,
  "/": 9,
  ":": 10,
  "[": 11,
  "]": 12,
  "«": 13,
  "»": 14,
  "،": 15,
  "؛": 16,
  "؟": 17,
  "ء": 18,
  "آ": 19,
  "أ": 20,
  "ؤ": 21,
  "إ": 22,
  "ئ": 23,
  "ا": 24,
  "ب": 25,
  "ة": 26,
  "ت": 27,
  "ث": 28,
  "ج": 29,
  "ح": 30,
  "خ": 31,
  "د": 32,
  "ذ": 33,
  "ر": 34,
  "ز": 35,
  "س": 36,
  "ش": 37,
  "ص": 38,
  "ض": 39,
  "ط": 40,
  "ظ": 41,
  "ع": 42,
  "غ": 43,
  "ف": 44,
  "ق": 45,
  "ك": 46,
  "ل": 47,
  "م": 48,
  "ن": 49,
  "ه": 50,
  "و": 51,
  "ى": 52,
  "ي": 53
}